[Map]
Tileset defaultTileset
Size 10 x 10

0 0 0 0 0 0 0 0 0 0
0 3 3 3 3 3 3 3 3 0
0 3 2 1 2 1 2 1 3 0
0 3 1 2 1 2 1 2 3 0
0 3 2 1 2 1 2 1 3 0
0 3 1 2 1 2 1 2 3 0
0 3 2 1 2 1 2 1 3 0
0 3 1 2 1 2 1 2 3 0
0 3 3 3 3 3 3 3 3 0
0 0 0 0 0 0 0 0 0 0

[Object]

bobj 80 80

[eof]
