[Map]
Tileset defaultTileset
Size 20 x 10

0 0 0 0 0 0 0 0 0 0 0 0 0 0 0 0 0 0 0 0
0 3 3 3 3 3 3 3 3 3 3 3 3 3 3 3 3 3 3 0
0 3 2 1 2 1 2 1 2 1 2 1 2 1 2 1 2 1 3 0
0 3 1 2 1 2 1 2 1 2 1 2 1 2 1 2 1 2 3 0
0 3 2 1 2 1 2 1 3 3 3 1 2 1 2 1 2 1 3 0
0 3 1 2 1 2 1 2 3 3 3 2 1 2 1 2 1 2 3 0
0 3 2 1 2 1 2 1 3 3 3 3 2 1 2 1 2 1 3 0
0 3 1 2 1 2 1 2 1 2 1 2 1 2 1 2 1 2 3 0
0 3 3 3 3 3 3 3 3 3 3 3 3 3 3 3 3 3 3 0
0 0 0 0 0 0 0 0 0 0 0 0 0 0 0 0 0 0 0 0

[Object]

sprite 79 81 Mario player

[eof]
