[Map]
Tileset ff6_kefkas_palast
Size 10 x 10

0  0  0  0  0  0  0  0  0  0
8  4  6  2  4  6  4  6  2  0
8  5  7  3  5  7  5  7  3  0
8  1  1  1  1  1  1  1  1  0
8  4  6  4  6  4  6  4  6  0
8  5  7  5  7  5  7  5  7  0
8  4  6  4  6  4  6  4  6  0
8  5  7  5  7  5  7  5  7  0
9  10 11 10 11 10 11 10 11 0
12 14 13 14 13 14 13 14 13 0

[Object]

sprite 80 80 Mario player

[eof]
