< tiles 1.0 Level >
[Map]
Tileset narshe_tileset ;;
Size 60 x 60 ;;
Data
0 1 1 1 1 1 1 1 1 1 1 1 1 1 1 1 1 1 2 3 3 2 4 5 6 7 8 9 10 11 12 13 14 15 16 1 17 1 18 19 20 21 22 23 23 24 25 26 1 1 1 1 1 1 1 1 1 1 1 1 
1 1 1 1 1 1 1 1 1 1 1 1 1 1 1 1 1 1 27 27 28 27 29 30 31 23 32 33 9 28 10 12 34 15 35 1 36 37 27 38 39 40 41 42 43 10 12 22 23 23 1 1 1 1 1 1 1 1 1 1 
1 1 1 1 1 1 1 1 1 1 1 1 1 1 1 1 44 45 12 27 13 31 1 23 32 28 27 46 12 13 33 47 34 48 35 49 50 51 42 52 53 42 42 43 33 54 55 56 28 43 57 1 1 1 1 1 1 1 1 1 
1 1 1 1 1 1 1 1 1 1 1 1 1 1 1 1 8 46 47 41 58 1 32 42 9 10 13 28 10 41 9 10 59 60 61 62 50 63 11 64 42 43 11 33 65 66 67 47 41 33 22 23 23 23 1 1 1 1 1 1 
0 1 1 1 1 1 1 1 1 1 1 1 1 1 23 23 32 10 33 68 69 8 33 11 12 13 41 70 13 28 12 13 19 71 72 62 73 1 74 75 11 76 77 46 78 33 42 43 77 9 10 42 43 9 22 1 1 1 1 1 
1 1 1 1 1 1 1 1 1 1 1 1 1 1 10 47 12 13 10 22 23 32 46 79 80 81 28 82 83 84 85 86 87 88 72 62 89 1 90 91 92 15 93 94 33 46 11 33 12 12 13 11 33 10 70 57 1 1 1 1 
1 1 1 1 1 1 1 1 1 1 1 1 1 1 27 27 9 10 70 56 28 27 27 95 96 97 98 99 100 101 102 103 104 105 106 107 108 89 90 109 109 110 109 111 109 112 77 46 47 113 33 77 46 56 28 57 1 1 1 1 
1 1 1 1 1 1 1 1 1 1 1 1 1 1 114 33 12 13 12 12 11 33 13 115 116 69 117 118 119 120 119 120 119 121 47 151 108 151 47 120 120 120 120 120 120 120 120 120 120 120 120 120 127 43 128 1 1 1 1 1 
0 1 1 1 1 1 1 1 1 1 1 1 1 1 46 33 47 41 9 10 12 13 41 129 1 32 27 52 130 131 130 132 133 131 134 151 108 151 138 19 59 60 61 139 20 72 140 141 142 143 124 15 144 145 57 1 1 1 1 1 
1 1 1 1 1 1 1 1 1 1 1 1 1 1 12 46 47 43 12 13 10 41 58 1 8 28 27 52 130 146 147 148 29 149 1 151 108 151 152 19 38 39 153 154 155 72 123 156 123 124 157 15 144 158 57 1 1 1 1 1 
1 1 1 1 1 1 1 1 159 160 161 162 163 2 58 30 29 29 47 41 13 31 69 23 32 27 27 10 147 164 114 165 166 15 167 151 108 151 109 38 168 155 72 169 170 153 19 171 172 34 157 48 35 173 22 1 1 1 1 1 
1 1 1 1 4 5 5 4 10 13 22 23 30 29 7 23 23 32 12 9 27 22 32 27 174 175 33 12 27 109 109 111 109 109 109 176 176 176 124 15 38 170 153 27 57 177 19 155 20 178 179 60 61 180 9 22 23 23 23 1 
0 1 1 1 41 10 47 41 9 10 42 41 22 23 32 27 28 27 181 27 13 42 9 13 182 183 184 13 114 141 140 141 143 15 143 62 176 62 34 15 187 188 189 77 190 15 191 170 39 59 192 193 194 61 43 33 43 43 43 1 
1 1 1 1 9 13 181 47 12 13 33 9 10 41 27 47 41 70 70 9 41 9 12 9 43 9 195 27 114 156 123 156 124 15 125 62 108 151 34 15 35 196 197 74 34 15 35 1 1 19 71 171 39 153 33 46 33 33 198 1 
1 1 1 1 27 27 13 9 41 41 12 12 13 27 33 12 27 199 47 11 181 12 43 12 13 27 28 200 201 202 203 202 34 48 35 62 151 151 34 15 35 196 206 74 34 15 35 22 1 207 208 209 57 1 90 56 28 28 1 1 
1 1 1 1 12 13 41 31 210 33 181 47 41 109 109 109 110 111 109 112 70 27 33 41 9 28 27 114 1 19 155 172 59 60 61 211 212 212 34 15 35 196 62 214 34 15 35 56 57 38 39 40 57 1 216 30 29 29 217 217 
0 1 1 1 27 41 68 1 8 46 70 114 30 142 141 124 15 125 141 218 27 9 10 181 12 13 70 58 1 38 170 153 19 219 72 220 221 221 109 110 109 62 62 62 34 48 35 33 57 1 1 18 22 1 1 1 1 1 1 1 
1 1 1 1 41 31 1 1 8 43 28 31 1 123 156 34 15 35 156 126 223 224 13 9 47 225 28 58 1 1 1 236 227 228 229 211 212 212 124 48 125 62 62 62 59 60 61 46 22 23 1 74 56 22 23 1 177 1 1 1 
1 1 1 1 68 1 1 1 1 210 114 1 1 19 71 34 48 35 139 72 230 188 41 12 231 15 232 233 234 235 1 236 237 238 239 62 108 151 59 60 61 62 62 62 19 71 72 42 223 223 57 90 56 33 12 243 15 16 1 1 
1 1 1 1 1 1 1 1 1 1 244 245 1 207 208 59 60 61 154 72 246 196 109 110 109 109 109 110 109 247 248 236 154 172 249 62 108 151 38 39 153 62 62 62 19 208 72 253 188 254 57 216 74 255 256 178 15 35 22 1 
0 1 1 1 1 1 1 1 23 23 32 257 1 38 39 19 20 72 169 153 258 196 124 15 125 141 124 15 125 211 259 236 169 39 153 107 108 151 203 203 203 62 62 62 38 39 153 90 196 263 57 1 264 265 266 34 15 35 56 22 
1 1 1 1 1 1 23 32 114 9 10 27 245 1 1 19 155 72 267 268 269 196 34 48 35 156 34 48 35 211 270 271 62 151 151 151 108 151 207 155 72 107 151 151 277 223 224 216 196 278 57 1 279 90 77 178 48 35 27 280 
1 1 1 1 23 32 9 10 10 12 13 12 281 245 1 38 170 153 47 282 41 196 59 60 61 202 59 60 61 211 283 283 62 151 151 151 108 151 38 170 153 151 151 151 283 188 290 259 196 291 22 1 1 292 42 59 60 61 28 57 
1 1 1 1 9 10 12 13 12 47 41 31 210 257 1 1 8 293 41 294 27 196 19 71 72 154 19 20 295 62 62 62 107 151 151 151 108 151 151 151 151 151 151 204 299 196 300 270 247 301 9 57 1 51 11 19 20 21 11 57 
0 1 1 1 302 13 47 41 42 43 68 1 8 12 303 1 32 304 47 305 68 196 19 208 249 169 19 155 72 176 176 108 108 108 108 108 108 108 108 108 108 108 108 108 151 223 224 277 277 309 12 57 1 18 9 38 39 40 43 22 
1 1 1 1 1 47 46 12 11 33 22 23 32 9 310 32 43 9 27 181 303 196 38 311 153 107 38 170 153 107 151 151 151 151 151 151 108 151 151 151 151 151 151 151 151 189 188 283 283 314 42 57 1 74 12 52 53 33 33 56 
1 1 1 1 1 181 41 31 90 56 56 28 27 33 28 27 33 315 316 317 318 319 151 151 151 108 151 151 151 151 151 151 151 151 151 151 108 151 151 151 151 151 151 151 151 323 196 324 325 326 11 57 327 74 33 64 42 43 28 42 
1 1 1 1 1 328 329 1 216 30 29 9 27 43 9 28 46 330 331 332 257 1 333 108 108 108 108 108 108 151 151 151 151 151 151 151 108 151 151 151 151 151 151 151 151 151 196 335 336 74 337 1 18 43 46 338 11 33 33 11 
0 1 160 25 3 339 1 1 1 23 32 12 13 12 12 13 12 43 9 340 58 1 542 319 151 151 151 151 151 19 20 20 34 15 344 62 176 62 178 15 125 123 123 126 62 151 151 151 346 347 177 37 9 56 27 46 46 77 33 77 
1 1 13 27 181 114 1 1 32 33 42 47 41 27 47 348 349 12 27 41 350 1 1 1 333 151 151 151 151 19 155 219 34 48 35 62 176 62 34 15 35 354 228 355 62 151 151 151 57 357 15 358 33 12 27 46 280 74 42 43 
45 5 10 12 27 31 1 8 27 28 11 27 12 47 10 359 360 332 12 13 27 245 1 333 151 151 151 151 151 38 170 39 59 60 61 62 176 62 34 15 35 365 238 239 211 212 366 367 357 178 15 35 42 47 43 27 57 90 11 33 
46 47 12 47 114 1 1 32 70 12 28 33 47 70 181 70 181 368 47 41 41 257 319 73 151 151 151 151 151 108 151 108 193 370 193 62 176 62 34 48 35 169 39 153 107 151 373 57 34 178 48 35 11 33 33 280 1 216 77 46 
12 56 42 43 31 1 32 11 33 41 114 12 28 33 12 47 77 43 12 27 27 114 1 1 151 151 62 62 151 151 151 151 375 15 376 62 176 62 59 60 61 211 212 212 212 379 380 1 34 179 60 61 77 43 56 22 1 1 74 381 
56 42 41 31 1 8 43 10 80 81 28 382 383 84 384 385 386 387 12 114 13 58 388 389 59 192 62 62 62 62 62 151 34 15 35 107 108 50 71 193 71 211 212 212 212 392 57 1 59 109 109 112 43 31 90 28 22 1 90 1 
28 10 68 1 1 8 27 393 96 97 98 394 102 103 395 103 396 397 398 9 10 399 1 8 400 219 62 62 62 62 62 62 178 15 35 221 221 221 208 171 208 62 151 151 151 74 57 1 19 123 123 126 33 57 63 42 43 57 216 1 
12 114 1 1 1 8 12 403 116 69 404 118 119 120 119 120 119 121 405 12 13 57 1 8 406 39 62 62 153 15 35 62 34 48 35 211 212 212 407 155 72 62 151 151 50 90 22 23 207 19 20 72 46 22 23 90 46 57 1 1 
27 58 1 1 23 32 33 129 1 1 32 411 412 413 414 415 416 417 9 12 47 22 23 8 12 418 62 62 419 15 35 62 59 60 61 211 212 212 38 170 153 107 151 151 151 422 423 263 38 19 155 21 42 43 47 27 43 22 1 1 
12 114 1 8 27 12 42 22 23 23 424 27 425 426 427 428 9 10 12 12 27 41 27 303 429 430 62 62 34 48 35 62 19 432 72 62 108 151 151 151 151 151 151 109 109 433 434 254 57 38 170 40 11 33 42 43 33 11 1 1 
10 41 303 8 27 9 10 56 28 224 223 224 27 41 27 11 9 28 9 10 28 181 70 318 8 435 62 62 59 60 61 62 203 203 203 62 108 151 151 151 151 151 50 123 123 436 437 263 22 1 1 63 77 46 11 33 46 47 1 1 
13 27 318 32 28 12 13 43 9 438 188 439 12 33 56 33 12 70 33 13 27 27 27 7 8 440 62 107 38 39 153 62 38 39 153 107 108 151 151 151 151 151 73 19 71 444 445 446 43 22 23 32 28 27 77 46 56 47 1 1 
10 12 46 9 9 47 41 33 12 447 196 46 41 42 9 10 33 12 47 41 181 70 114 22 32 13 448 151 203 203 203 107 151 151 151 151 108 151 151 151 151 50 1 207 208 20 27 42 33 12 13 12 13 27 27 27 46 128 1 1 
12 13 33 11 27 13 28 46 47 11 223 223 224 11 27 13 28 47 70 79 80 27 27 43 9 41 451 151 38 39 153 151 151 151 151 62 176 62 151 151 151 151 109 109 453 454 74 11 33 109 109 112 41 31 90 56 28 57 1 1 
47 41 33 56 33 41 56 33 43 77 278 188 455 12 29 68 74 181 181 95 96 31 456 9 12 41 114 457 151 151 151 151 151 151 151 62 176 62 59 61 458 123 123 459 460 57 74 461 462 123 123 126 27 22 216 30 29 57 1 1 
463 198 42 9 10 41 28 42 33 31 30 196 68 69 23 23 216 456 27 115 116 1 8 12 27 27 114 1 347 464 139 219 20 71 71 62 176 62 71 71 154 219 209 465 41 57 466 467 468 19 172 72 47 41 22 23 32 57 1 1 
0 1 11 27 13 41 33 11 46 22 1 196 1 32 10 28 22 23 30 29 1 1 8 12 13 27 469 1 23 32 470 39 39 208 208 62 176 62 208 208 169 39 40 56 28 57 474 30 29 38 39 153 12 42 43 42 128 388 1 1 
1 1 56 27 41 31 456 12 13 42 22 23 32 27 9 70 42 10 57 1 1 23 32 47 41 27 22 32 27 43 475 476 283 311 311 62 176 62 311 311 283 283 480 28 56 22 23 23 481 482 483 484 463 485 198 381 486 486 1 1 
1 1 56 181 27 57 1 90 56 56 33 27 181 10 12 33 11 33 57 23 32 10 43 9 10 47 41 9 10 33 487 15 488 489 490 62 176 62 490 489 296 493 33 31 90 56 28 27 1 1 1 1 1 1 1 1 1 1 1 1 
1 1 43 10 33 22 1 216 30 29 33 41 28 13 47 9 10 31 8 181 33 13 33 12 13 42 27 12 13 27 494 15 35 495 496 62 176 62 497 498 499 500 9 22 216 30 29 12 4 501 1 1 1 1 1 1 1 1 1 1 
0 1 181 181 33 33 57 1 23 32 27 9 27 27 28 27 58 1 32 70 46 41 46 47 41 27 27 56 56 114 157 15 35 283 283 62 176 62 283 283 502 33 56 33 22 23 32 33 41 56 1 1 1 1 1 1 1 1 1 1 
1 1 28 12 56 70 22 32 28 33 47 12 13 33 11 33 69 8 56 28 27 27 68 30 29 503 504 33 11 505 178 15 35 62 62 107 108 50 508 508 509 46 11 43 9 28 27 56 56 33 1 1 1 1 1 1 1 1 1 1 
1 1 510 70 11 33 42 43 9 46 41 47 41 33 56 27 22 1 30 29 68 69 23 23 1 143 143 511 512 143 34 48 35 62 107 151 108 151 151 151 516 33 77 31 30 29 68 30 11 68 1 1 1 1 1 1 1 1 1 1 
1 1 1 381 33 181 11 33 12 13 9 27 33 42 43 33 28 57 1 1 1 8 28 28 22 123 123 123 123 123 179 60 61 62 151 221 221 221 151 151 151 516 11 270 247 247 247 247 74 22 1 1 1 1 1 1 1 1 1 1 
0 1 1 1 33 33 77 46 47 41 12 13 9 11 181 33 27 22 23 23 23 32 28 56 11 19 219 20 71 20 192 193 194 220 221 212 212 212 221 221 221 221 521 277 277 277 522 523 90 56 1 1 1 1 1 1 1 1 1 1 
1 1 1 1 33 33 33 33 9 10 47 28 12 56 28 56 42 56 33 28 27 43 9 9 10 19 208 20 208 20 207 155 72 211 212 108 108 108 212 212 212 212 212 529 530 531 532 57 216 30 1 1 1 1 1 1 1 1 1 1 
1 1 1 1 1 90 56 33 12 13 9 27 41 12 70 11 11 33 12 27 12 13 12 12 533 534 311 39 311 39 38 170 153 107 151 108 108 108 151 151 151 50 17 326 57 37 47 22 23 1 1 1 1 1 1 1 1 1 1 1 
1 1 1 1 1 216 30 29 47 41 12 27 42 29 42 77 77 46 12 28 9 10 56 114 57 1 389 319 543 73 49 50 49 151 151 108 108 108 151 151 73 17 327 541 1 51 42 43 28 22 1 1 1 1 1 1 1 1 1 1 
0 1 1 1 1 1 1 8 33 28 70 27 129 1 456 74 28 33 47 33 12 13 33 27 22 23 32 245 1 1 542 73 17 542 151 543 151 151 543 73 1 1 18 57 1 18 11 33 42 43 1 1 1 1 1 1 1 1 1 1 
1 1 1 1 1 1 1 8 42 12 27 68 1 1 1 90 56 13 9 46 47 41 28 56 56 28 27 7 1 1 1 1 1 1 17 49 151 50 1 1 1 37 42 57 1 74 77 46 11 33 1 1 1 1 1 1 1 1 1 1 
1 1 1 1 1 23 23 32 46 47 114 245 1 1 1 216 30 29 29 29 29 29 29 68 30 29 68 1 1 1 1 1 1 1 1 333 151 73 1 1 1 51 11 57 1 90 56 28 77 46 1 1 1 1 1 1 1 1 1 1 
1 1 1 1 32 28 9 10 77 33 33 257 1 1 1 1 1 1 1 1 1 1 1 1 1 1 1 1 1 1 1 1 1 1 1 542 50 1 1 1 1 544 77 22 23 32 42 43 12 42 1 1 1 1 1 1 1 1 1 1 
;;
[Object]
sprite 36 55 Terra player ;;
[Event]
[eof]
